20
20
00100001000010000100
00011000110001100011
11100111001110011100
10000100001000010000
00110001100011000110
00100001000010000100
00011000110001100011
11100111001110011100
10000100001000010000
00110001100011000110
00100001000010000100
00011000110001100011
11100111001110011100
10000100001000010000
00110001100011000110
00100001000010000100
00011000110001100011
11100111001110011100
10000100001000010000
00110001100011000110