10
10
0010000100
0001100011
1110011100
1000010000
0011000110
0010000100
0001100011
1110011100
1000010000
0011000110